11111111111
11110000001
10000101011
11100001001
10100000001
10100111001
10000001001
11111111111
